MAP:2,NPC:1:1:3
0:0,WTL:1:7:0
0:1,WTL:1:7:1
0:2,WTL:1:7:2
0:3,WTL:1:7:3
0:4,WTL:1:7:4
0:5,WTL:1:7:5
0:6,WTL:1:7:6

7:0,WTR:1:0:0
7:1,WTR:1:0:1
7:2,WTR:1:0:2
7:3,WTR:1:0:3
7:4,WTR:1:0:4
7:5,WTR:1:0:5
7:6,WTR:1:0:6

0:0,WTU:1:0:6
1:0,WTU:1:1:6
2:0,WTU:1:2:6
3:0,WTU:1:3:6
4:0,WTU:1:4:6
5:0,WTU:1:5:6
6:0,WTU:1:6:6
7:0,WTU:1:7:6

0:6,WTD:1:0:0
1:6,WTD:1:1:0
2:6,WTD:1:2:0
3:6,WTD:1:3:0
4:6,WTD:1:4:0
5:6,WTD:1:5:0
6:6,WTD:1:6:0
7:6,WTD:1:7:0

2:2,B:T
2:3,B:T
2:4,B:T
3:2,B:T
3:3,B:T
3:4,B:T