MAP:1,NPC:0:0:4,NPC:0:4:5
0:0,WTL:2:7:0
0:1,WTL:2:7:1
0:2,WTL:2:7:2
0:3,WTL:2:7:3
0:4,WTL:2:7:4
0:5,WTL:2:7:5
0:6,WTL:2:7:6

7:0,WTR:2:0:0
7:1,WTR:2:0:1
7:2,WTR:2:0:2
7:3,WTR:2:0:3
7:4,WTR:2:0:4
7:5,WTR:2:0:5
7:6,WTR:2:0:6

0:0,WTU:2:0:6
1:0,WTU:2:1:6
2:0,WTU:2:2:6
3:0,WTU:2:3:6
4:0,WTU:2:4:6
5:0,WTU:2:5:6
6:0,WTU:2:6:6
7:0,WTU:2:7:6

0:6,WTD:2:0:0
1:6,WTD:2:1:0
2:6,WTD:2:2:0
3:6,WTD:2:3:0
4:6,WTD:2:4:0
5:6,WTD:2:5:0
6:6,WTD:2:6:0
7:6,WTD:2:7:0